111111111111111111111111
100000000000000000000111
111111000001111000100001
111111100000000000000001
100000000000000000000011
111111111111111111111111
